11111111111111111
10000H00000000001
100E0000000000001
10000000000000001
100000000000000v1
10000000000000001
10000000000000001
1000000CC00000001
1000000CC00000001
10000000000000001
10000000000000001
10000000000000001
1V000000000000001
10000000000000001
1000000000000P001
1000000000000h001
11111111111111111